111111111111111111
100000010000000001
111110000111100001
100011100100110001
10011000E001100001
1000CC00PC0C0001P1
111111111111111111