1111111111111111111
10C0100000000000001
1111100001111000011
1000111001001100011
100111110E001101001
10000C000C0C0001P11
1111111111111111111