1111111111111111
10C0000000000001
1111100C01111001
10001111110E1101
1001100000011001
10000000000000P1
1111111111111111
