111111111111111111111
11C000000000000000001
111111000111110001001
100C0001111E1110C1001
1111100110001P1111001
100000000001100000001
111111111111111111111