111111111111111111111
11C000000000000000001
111110000111110001001
100C1001111E1110C1001
1011100000001P1111001
100000000001100000001
111111111111111111111
