1111111111111111111
111000000C000000001
11C0011111111110C01
1100111000000010001
110000101111C000001
111100101C011111111
1000001011000000001
1C00111000011110111
11001C0001110E10001
11001111111C0111101
11000000P1100000001
1111111111111111111
