1111111111111111111
1110000000000000001
11C0011111111110001
1100111000000010001
1100001011110000001
111100101C011111111
1000001011000000001
1000111000011110001
11001C0001110E10001
1100111111100110001
11000000P1100000001
1111111111111111111
